EEEEEEEEEEEEEEEEEEEEEEEEEEEEE
EEE11111111111111111111111EEE
EEE11111111111111111111111EEE
EEE11111111111111111111111EEE
EEE11111111111111111111111EEE
EEE11111111111111111111111EEE
EEE11111111111111111111111EEE
EE2222222222222222222222222EE
E222222222222222222222222222E
33333333333333333333333333333
E222222222222222222222222222E
EE2222222222222222222222222EE
EEE11111111111111111111111EEE
EEE11111111111111111111111EEE
EEE11111111111111111111111EEE
EEE11111111111111111111111EEE
EEE11111111111111111111111EEE
EEE11111111111111111111111EEE
EEE11111111111111111111111EEE