EEEEEEEEEEEEEEEEEEEEEEEEEEE
EEE111111111111111111111EEE
EEE111111111111111111111EEE
EEE111111111111111111111EEE
EEE111111111111111111111EEE
EEE111111111111111111111EEE
EEE111111111111111111111EEE
EE22222222222222222222222EE
E2222222222222222222222222E
333333333333333333333333333
E2222222222222222222222222E
EE22222222222222222222222EE
EEE111111111111111111111EEE
EEE111111111111111111111EEE
EEE111111111111111111111EEE
EEE111111111111111111111EEE
EEE111111111111111111111EEE
EEE111111111111111111111EEE
EEE111111111111111111111EEE